{
  "id": "ishetar_new",
  "displayName": "Ishetar",
  "gridWidth": 32,
  "gridHeight": 24,
  "terrain": [
    [0,0,0,0,0,0,0,0,0,0,0,0,0,0,0,0,0,0,0,0,0,0,0,0,0,0,0,0,0,0,0,0],
    [0,0,0,0,0,2,2,2,2,2,2,2,2,2,2,2,2,2,2,2,2,2,2,2,2,2,2,0,0,0,0,0],
    [0,0,0,0,0,2,2,2,2,0,0,0,0,0,0,0,0,0,0,0,0,0,0,0,0,0,2,0,0,0,0,0],
    [0,0,0,0,0,0,2,2,2,0,2,2,0,0,0,0,0,0,0,0,0,2,2,2,0,0,2,0,0,0,0,0],
    [0,0,0,0,0,0,2,2,2,0,2,2,0,0,0,0,0,0,0,0,0,2,2,0,0,0,2,0,0,0,0,0],
    [0,0,0,0,0,0,2,0,0,0,0,0,0,0,0,0,0,0,0,0,0,0,0,0,0,0,2,0,0,0,0,0],
    [0,0,0,0,0,0,2,2,2,0,0,0,0,0,0,0,0,0,0,0,0,0,0,0,0,0,2,0,0,0,0,0],
    [0,0,0,0,0,0,2,2,2,0,0,0,0,0,0,0,0,0,0,0,0,0,0,0,0,0,2,0,0,0,0,0],
    [0,0,0,0,0,0,2,2,2,0,0,0,0,0,0,0,0,0,0,0,0,0,0,0,0,0,2,0,0,0,0,0],
    [0,0,0,0,0,0,2,2,2,0,0,0,0,0,0,0,0,0,0,0,0,0,0,0,0,0,2,0,0,0,0,0],
    [0,0,0,0,0,0,2,2,2,0,0,0,0,0,0,0,0,0,0,0,0,0,0,0,0,0,2,0,0,0,0,0],
    [0,0,0,0,0,0,2,2,2,0,0,0,0,0,0,0,0,0,2,0,0,0,0,0,0,0,2,0,0,0,0,0],
    [0,0,0,0,0,0,2,2,2,0,0,0,0,0,0,0,0,0,2,0,0,0,0,0,0,0,2,0,0,0,0,0],
    [0,0,0,0,0,0,2,2,2,0,0,0,0,0,0,0,0,0,0,0,0,0,0,0,0,0,2,0,0,0,0,0],
    [0,0,0,0,0,0,2,2,2,0,0,0,0,0,0,0,0,0,0,0,0,0,0,0,0,0,2,0,0,0,0,0],
    [0,0,0,0,0,0,2,2,2,0,0,0,0,0,0,0,0,0,0,0,0,0,0,0,0,0,2,0,0,0,0,0],
    [0,0,0,0,0,0,2,2,2,0,0,0,2,2,0,0,0,0,0,0,0,0,0,0,0,0,2,0,0,0,0,0],
    [0,0,0,0,0,0,2,2,2,0,0,0,2,2,0,0,0,0,0,0,0,0,0,0,0,0,2,0,0,0,0,0],
    [0,0,0,0,0,0,2,0,0,0,2,2,2,2,0,0,0,0,0,0,0,0,0,0,0,0,2,0,0,0,0,0],
    [0,0,0,0,0,0,2,2,2,2,2,2,0,0,0,0,0,0,0,0,0,0,0,0,0,0,2,0,0,0,0,0],
    [0,0,0,0,0,0,2,2,2,2,2,2,0,0,0,0,0,0,0,0,0,0,0,0,0,0,2,0,0,0,0,0],
    [0,0,0,0,0,0,2,2,2,2,2,2,2,2,2,2,2,2,2,2,0,0,2,2,2,2,2,0,0,0,0,0],
    [0,0,0,0,0,0,0,0,0,0,0,0,0,0,0,0,0,0,0,0,0,0,0,0,0,0,0,0,0,0,0,0],
    [0,0,0,0,0,0,0,0,0,0,0,0,0,0,0,0,0,0,0,0,0,0,0,0,0,0,0,0,0,0,0,0]
  ],
  "npcs": [
    { "id": "rowena", "name": "Lady Rowena", "x": 21, "y": 5, "portrait": null, "dialogue": "rowena_intro" },
    { "id": "guard_north", "name": "Town Guard", "x": 14, "y": 3, "portrait": null, "dialogue": "guard_north" },
    { "id": "guard_east", "name": "Town Guard", "x": 25, "y": 10, "portrait": null, "dialogue": "guard_east" },
    { "id": "pelor", "name": "Shrine", "x": 8, "y": 4, "portrait": null, "dialogue": "pelor" },
    { "id": "villager_male", "name": "Baker", "x": 9, "y": 9, "portrait": null, "dialogue": "villager_male" },
    { "id": "villager_female", "name": "Gertrude", "x": 9, "y": 15, "portrait": null, "dialogue": "villager_female" },
    { "id": "child_male", "name": "Young Boy", "x": 15, "y": 18, "portrait": null, "dialogue": "child_male" },
    { "id": "child_female", "name": "Young Girl", "x": 22, "y": 15, "portrait": null, "dialogue": "child_female" },
    { "id": "hrothgar", "name": "Hrothgar", "x": 12, "y": 15, "portrait": null, "dialogue": "hrothgar" }
  ],
  "heroPositions": [
    { "x": 17, "y": 10 },
    { "x": 19, "y": 10 },
    { "x": 17, "y": 12 },
    { "x": 19, "y": 12 }
  ],
  "playerStart": { "x": 11, "y": 5 },
  "triggers": [
    {
      "id": "south_gate_battle",
      "type": "battle",
      "tiles": [
        { "x": 20, "y": 19 },
        { "x": 21, "y": 19 },
        { "x": 20, "y": 20 },
        { "x": 21, "y": 20 }
      ],
      "battleMap": "south_gate",
      "cutscene": [
        "To Arms! Monsters at the South Gate!",
        "They're chasing someone! Quick, somebody help her!"
      ]
    }
  ]
}
