{
  "id": "quetzi_shrine",
  "displayName": "Quetzi Shrine",
  "gridWidth": 24,
  "gridHeight": 16,
  "terrain": [
    [2,2,2,2,2,2,2,2,2,2,2,2,2,2,2,2,2,2,2,2,2,2,2,2],
    [2,2,2,2,2,2,2,2,2,2,1,1,1,2,2,2,0,0,0,0,0,0,0,0],
    [2,2,2,2,2,2,2,2,2,2,1,1,1,0,0,0,0,0,0,0,0,2,0,0],
    [0,2,0,0,0,0,0,0,0,0,0,0,0,0,0,0,0,0,0,0,0,2,0,0],
    [0,2,0,0,0,0,0,0,0,0,1,1,1,0,0,0,0,0,0,0,0,0,1,0],
    [0,2,0,0,0,0,0,0,0,0,1,1,1,0,0,0,0,0,0,0,0,0,1,0],
    [0,2,0,0,0,0,0,0,0,0,0,0,0,0,0,0,0,0,0,0,0,0,0,0],
    [0,1,1,0,0,0,0,1,1,0,0,0,0,0,0,1,0,0,0,0,0,1,0,0],
    [0,1,1,0,0,0,0,1,1,0,0,0,0,0,0,1,0,0,0,0,0,1,0,0],
    [0,1,1,0,0,0,0,1,1,0,0,0,0,0,0,1,0,0,0,0,0,2,0,0],
    [0,2,0,0,0,0,0,0,0,0,0,0,0,0,0,0,0,0,0,0,0,2,2,0],
    [0,2,0,0,0,0,0,2,0,0,1,1,1,0,0,2,0,0,0,0,0,2,2,0],
    [0,2,0,0,0,0,0,2,2,0,0,0,0,0,2,2,0,0,0,0,0,2,2,0],
    [2,2,0,0,0,0,0,0,0,0,0,0,0,0,0,0,0,0,0,0,0,2,2,2],
    [2,2,2,0,0,0,0,0,0,0,0,1,1,0,0,0,0,0,0,0,2,2,2,2],
    [2,2,2,0,0,0,0,0,0,0,0,1,1,0,0,2,2,2,2,2,2,2,2,2]
  ],
  "npcs": [],
  "heroPositions": [
    { "x": 2, "y": 8 },
    { "x": 2, "y": 7 },
    { "x": 2, "y": 9 },
    { "x": 1, "y": 7 },
    { "x": 1, "y": 9 }
  ],
  "playerStart": { "x": 2, "y": 8 }
}
