{
  "id": "south_gate",
  "displayName": "South Gate",
  "gridWidth": 32,
  "gridHeight": 32,
  "terrain": [
    [2,2,2,2,2,0,2,2,0,0,0,0,0,0,0,0,0,0,0,0,0,0,0,0,2,0,0,2,2,2,2,2],
    [2,2,2,2,2,0,2,2,0,0,0,0,0,0,0,0,0,0,0,0,0,0,0,0,2,0,0,2,2,2,2,2],
    [2,2,2,2,2,0,2,2,0,0,0,1,1,1,1,1,1,1,1,1,1,0,0,0,2,0,0,0,2,2,2,2],
    [2,2,2,2,2,0,2,2,0,0,0,0,0,0,1,1,1,1,1,1,0,0,0,0,2,0,0,0,2,2,2,2],
    [2,2,2,2,0,0,2,2,0,0,0,0,0,0,0,1,1,1,0,0,0,0,0,0,2,0,0,1,1,1,2,2],
    [2,2,2,1,0,0,2,2,0,0,0,0,0,0,0,1,1,0,0,0,0,0,0,0,2,0,0,1,1,1,2,2],
    [2,2,1,1,1,0,2,2,2,2,2,2,2,2,2,1,1,2,2,2,2,2,2,2,2,2,0,1,1,1,2,2],
    [2,2,1,1,1,0,2,2,2,2,2,2,2,2,2,1,1,2,2,2,2,2,2,2,2,2,0,0,0,0,2,2],
    [2,2,0,1,0,0,2,2,2,2,2,2,2,2,2,1,1,2,2,2,2,2,2,2,2,2,0,1,0,0,2,2],
    [2,2,0,0,0,0,0,0,0,0,0,0,0,0,0,1,1,0,0,0,0,0,0,0,0,0,0,0,1,0,2,2],
    [2,2,0,0,0,0,0,0,0,0,0,0,0,0,1,1,1,1,0,0,0,0,0,0,0,0,0,0,0,0,2,2],
    [0,0,0,0,0,1,1,1,0,0,0,0,0,0,1,1,1,1,0,0,0,0,0,0,1,0,0,0,0,0,2,2],
    [0,0,0,0,1,1,1,1,1,0,0,0,0,0,1,1,1,1,0,0,0,0,1,1,1,1,0,0,0,2,2,2],
    [0,0,0,1,1,1,1,1,1,1,0,0,0,0,1,1,1,1,0,0,0,0,1,1,1,1,0,0,2,2,2,2],
    [1,1,1,1,1,1,1,1,1,1,0,0,0,0,1,1,1,1,0,0,0,0,1,1,1,1,0,0,2,2,2,2],
    [1,1,1,1,1,1,1,1,1,1,1,0,0,0,1,1,1,1,0,0,0,0,0,1,1,0,0,0,2,2,2,2],
    [1,1,1,1,1,1,1,1,1,1,1,0,0,0,1,1,1,1,0,0,0,0,0,0,0,0,0,0,2,2,2,2],
    [0,0,0,1,1,1,1,1,1,1,1,0,0,0,1,1,1,1,0,0,0,0,0,0,0,0,0,0,0,2,2,2],
    [2,0,0,0,1,1,1,1,0,0,0,0,0,0,1,1,1,1,0,0,0,0,0,0,0,0,0,0,0,0,2,2],
    [2,2,0,0,1,1,1,0,0,0,0,0,0,0,1,1,1,1,0,0,0,1,1,0,0,0,0,1,0,0,2,2],
    [2,2,0,0,0,0,0,0,0,0,0,0,0,0,1,1,1,1,0,0,0,1,1,0,0,0,0,0,1,0,2,2],
    [2,2,0,0,0,0,0,0,0,0,0,0,0,0,1,1,1,1,0,0,0,0,0,0,0,0,0,0,0,0,2,2],
    [2,2,0,0,0,0,0,0,0,0,0,0,0,0,1,1,1,1,0,0,0,0,0,0,0,0,0,0,0,2,2,2],
    [2,2,2,0,0,0,0,0,0,0,0,0,0,0,1,1,1,1,0,0,0,0,1,1,1,1,0,0,0,2,2,2],
    [2,2,2,2,0,1,1,0,0,1,1,0,0,0,1,1,1,1,0,0,0,0,1,1,1,1,0,0,0,2,2,2],
    [2,2,2,2,0,0,0,0,0,0,0,0,0,0,1,1,1,1,0,0,0,1,1,1,1,1,0,0,2,2,2,2],
    [2,2,2,2,0,0,0,0,0,0,0,0,0,0,1,1,1,1,0,0,0,1,1,1,1,0,0,0,2,2,2,2],
    [2,2,2,2,2,0,0,0,0,0,0,0,0,0,1,1,1,1,0,0,0,0,0,0,0,0,0,0,2,2,2,2],
    [2,2,2,2,2,2,2,0,0,0,0,0,0,0,1,1,1,1,0,0,0,0,0,0,0,0,2,2,2,2,2,2],
    [2,2,2,2,2,2,2,0,0,0,0,0,0,0,1,1,1,1,0,0,0,0,0,0,0,2,2,2,2,2,2,2],
    [2,2,2,2,2,2,2,2,2,2,2,2,0,0,1,1,1,1,0,0,2,2,2,2,2,2,2,2,2,2,2,2],
    [2,2,2,2,2,2,2,2,2,2,2,2,2,0,1,1,1,1,0,2,2,2,2,2,2,2,2,2,2,2,2,2]
  ],
  "npcs": [],
  "playerStart": { "x": 16, "y": 28 }
}
